planetlab1.nileu.edu.eg	PLC	boot		
charon.cs.binghamton.edu	PLC	boot		
planetlab01.erin.utoronto.ca	PLC	boot		
pl1.bit.uoit.ca	PLC	boot		
planetlab-1a.ics.uci.edu	PLC	boot		
node1.planetlab.etl.luc.edu	PLC	boot		
planetlab02.erin.utoronto.ca	PLC	boot		
deimos.cecalc.ula.ve	PLC	boot		
planetlabnode-2.docomolabs-usa.com	PLC	boot		
planetlab1.iitr.ernet.in	PLC	boot		
planetlab2.cse.msu.edu	PLC	boot		
planetlab2.cs.duke.edu	PLC	boot		
planetlab0.ias.csusb.edu	PLC	boot		
planetlab5.cs.duke.edu	PLC	boot		
planetlab-01.naist.jp	PLC	boot		
planetlab-04.naist.jp	PLC	boot		
pl1.cewit.stonybrook.edu	PLC	boot		
pli1-br-3.hpl.hp.com	PLC	boot		
pli2-br-2.hpl.hp.com	PLC	boot		
planetlab2.iii.u-tokyo.ac.jp	PLC	boot		
planetlab1.ece.ucdavis.edu	PLC	boot		
pli1-br-2.hpl.hp.com	PLC	boot		
pli2-br-1.hpl.hp.com	PLC	boot		
pli1-tlnx.hpl.hp.com	PLC	boot		
pluto.cs.binghamton.edu	PLC	boot		
pl2.cewit.stonybrook.edu	PLC	boot		
planetlab1.cs.wayne.edu	PLC	boot		
planetlab-02.naist.jp	PLC	boot		
planetlab2.olsztyn.rd.tp.pl	PLC	boot		
planetlab2.uc.edu	PLC	boot		
planetlab3.csail.mit.edu	PLC	boot		
planetlab-03.naist.jp	PLC	boot		
planetlab-1.vuse.vanderbilt.edu	PLC	boot		
planetlab-2.vuse.vanderbilt.edu	PLC	boot		
planetlab-3.ics.uci.edu	PLC	boot		
planetlab1.n.info.eng.osaka-cu.ac.jp	PLC	boot		
node1.planet-lab.titech.ac.jp	PLC	boot		
node3.planet-lab.titech.ac.jp	PLC	boot		
node4.planet-lab.titech.ac.jp	PLC	boot		
planetlab3.n.info.eng.osaka-cu.ac.jp	PLC	boot		
pn1-planetlab.huawei.com	PLC	boot		
pn2-planetlab.huawei.com	PLC	boot		
node0.planetlab.etl.luc.edu	PLC	boot		
planetlab1.keldysh.ru	PLC	boot		
planetlab2.keldysh.ru	PLC	boot		
planetlab1.cs.dartmouth.edu	PLC	boot		
planetlab1.simula.no	PLC	boot		
itchy.cs.uga.edu	PLC	boot		
planetlab-1.ece.iastate.edu	PLC	boot		
mnc2.pusan.ac.kr	PLC	boot		
planetlab1.iin-bit.com.cn	PLC	boot		
planetlab2.nileu.edu.eg	PLC	boot		
planetlab1.cse.msu.edu	PLC	boot		
planetlabnode-1.docomolabs-usa.com	PLC	boot		
mnc1.pusan.ac.kr	PLC	boot		
planetlab2.iitr.ernet.in	PLC	boot		
fobos.cecalc.ula.ve	PLC	boot		
planetlab3.cesnet.cz	PLC	boot		
pli1-pa-1.hpl.hp.com	PLC	boot		
planetlab-1.cs.colostate.edu	PLC	boot		
planetlab-5.eecs.cwru.edu	PLC	boot		
pnode1.pdcc-ntu.singaren.net.sg	PLC	boot		
iason.inf.uth.gr	PLE	boot		
planetlab1.cs.ubc.ca	PLC	boot		
iraplab2.iralab.uni-karlsruhe.de	PLE	boot		
plewifi.ipv6.lip6.fr	PLE	boot		
planetlab3.hiit.fi	PLE	boot		
dev-res-plab-01.tid.es	PLE	boot		
ple1.hpca.ual.es	PLE	boot		
planetlab2.ie.cuhk.edu.hk	PLC	boot		
planetlab2.upm.ro	PLE	boot		
planetlab1.unr.edu	PLC	boot		
dannan.disy.inf.uni-konstanz.de	PLE	boot		
ple4.ipv6.lip6.fr	PLE	boot		
planetlab2.ci.pwr.wroc.pl	PLE	boot		
planetlab2.u-strasbg.fr	PLE	boot		
planetlaba.engr.ccny.cuny.edu	PLC	boot		
planetlab-coffee.ait.ie	PLE	boot		
planetlab1.diku.dk	PLE	boot		
planet2.inf.tu-dresden.de	PLE	boot		
planetlab3.cslab.ece.ntua.gr	PLE	boot		
merkur.planetlab.haw-hamburg.de	PLE	boot		
chronos.disy.inf.uni-konstanz.de	PLE	boot		
planetlab-2.man.poznan.pl	PLE	boot		
node2.planetlab.uni-luebeck.de	PLE	boot		
planetlab-4.cs.ucy.ac.cy	PLE	boot		
planetlab2.informatik.uni-kl.de	PLE	boot		
gschembra3.diit.unict.it	PLE	boot		
ple2.hpca.ual.es	PLE	boot		
planetlab-2.ing.unimo.it	PLE	boot		
planetlab1.ifi.uio.no	PLE	boot		
planet2.servers.ua.pt	PLE	boot		
host2.planetlab.informatik.tu-darmstadt.de	PLE	boot		
mars.planetlab.haw-hamburg.de	PLE	boot		
onelab3.info.ucl.ac.be	PLE	boot		
planetlab2.s3.kth.se	PLE	boot		
planetlab1.informatik.uni-goettingen.de	PLE	boot		
planetlab1-tijuana.lan.redclara.net	PLC	boot		
planetlab2.ics.forth.gr	PLE	boot		
planetlab1.ci.pwr.wroc.pl	PLE	boot		
planetlab1.u-strasbg.fr	PLE	boot		
dplanet1.uoc.edu	PLE	boot		
planetlab2.utt.fr	PLE	boot		
planetlab1.fct.ualg.pt	PLE	boot		
planetlab01.dis.unina.it	PLE	boot		
planetlab2.urv.cat	PLE	boot		
stella.planetlab.ntua.gr	PLE	boot		
planetlab1.informatik.uni-kl.de	PLE	boot		
ple2.ait.ac.th	PLE	boot		
plato.di.uoa.gr	PLE	boot		
lim-planetlab-2.univ-reunion.fr	PLE	boot		
dev-res-plab-02.tid.es	PLE	boot		
ricepl-1.cs.rice.edu	PLC	boot		
pl2.eecs.utk.edu	PLC	boot		
planetlab2.postel.org	PLC	boot		
planetlab2.cs.ubc.ca	PLC	boot		
planetlab1.postel.org	PLC	boot		
planetlab3.cs.columbia.edu	PLC	boot		
planetlab2.csee.usf.edu	PLC	boot		
planet-lab1.cs.ucr.edu	PLC	boot		
planetlab4.georgetown.edu	PLC	boot		
planetlab2.iis.sinica.edu.tw	PLC	boot		
planetlab1.cs.purdue.edu	PLC	boot		
planetlab4.cs.uiuc.edu	PLC	boot		
planetlab-1.usask.ca	PLC	boot		
planetlab2-tijuana.lan.redclara.net	PLC	boot		
node2pl.planet-lab.telecom-lille1.eu	PLE	boot		
planetlab3.cs.uoregon.edu	PLC	boot		
cs-planetlab3.cs.surrey.sfu.ca	PLC	boot		
planetlab2.csie.nuk.edu.tw	PLC	boot		
planetlab8.millennium.berkeley.edu	PLC	boot		
pln.zju.edu.cn	PLC	boot		
plgmu1.ite.gmu.edu	PLC	boot		
planetlab2.unr.edu	PLC	boot		
planetlab4.rutgers.edu	PLC	boot		
planetlab1.jhu.edu	PLC	boot		
planet-lab3.uba.ar	PLC	boot		
planetlab2.cs.pitt.edu	PLC	boot		
pl2.zju.edu.cn	PLC	boot		
planetlab2.cs.okstate.edu	PLC	boot		
planet1.cs.rochester.edu	PLC	boot		
planetlab1.cs.du.edu	PLC	boot		
planetlab-3.cs.ucy.ac.cy	PLE	boot		
planetlab2.cs.uit.no	PLE	boot		
utet.ii.uam.es	PLE	boot		
planet1.scs.cs.nyu.edu	PLC	boot		
planetlab2.eecs.umich.edu	PLC	boot		
planetlab02.cs.washington.edu	PLC	boot		
planetlab1.virtues.fi	PLE	boot		
planetlab2.koganei.itrc.net	PLC	boot		
orbpl2.rutgers.edu	PLC	boot		
planetlab-02.ece.uprm.edu	PLC	boot		
planetlab1.ucsd.edu	PLC	boot		
planetlab5.csail.mit.edu	PLC	boot		
planetlab1.citadel.edu	PLC	boot		
planetlab2-buenosaires.lan.redclara.net	PLC	boot		
plab1.cs.ust.hk	PLC	boot		
mercury.silicon-valley.ru	PLC	boot		
venus.silicon-valley.ru	PLC	boot		
planetlab4.csres.utexas.edu	PLC	boot		
planetlab1.unl.edu	PLC	boot		
planetlab2.poly.edu	PLC	boot		
planetlab12.millennium.berkeley.edu	PLC	boot		
planetlab1.utep.edu	PLC	boot		
salt.planetlab.cs.umd.edu	PLC	boot		
planetlab2.cs.uoregon.edu	PLC	boot		
planetlab13.millennium.berkeley.edu	PLC	boot		
planetlab5.eecs.umich.edu	PLC	boot		
ebb.colgate.edu	PLC	boot		
pl1.eng.monash.edu.au	PLC	boot		
planetlab2.uta.edu	PLC	boot		
planetlab7.csres.utexas.edu	PLC	boot		
ricepl-4.cs.rice.edu	PLC	boot		
miranda.planetlab.cs.umd.edu	PLC	boot		
pli1-pa-6.hpl.hp.com	PLC	boot		
planetlab6.csres.utexas.edu	PLC	boot		
planetlab2.cs.stevens-tech.edu	PLC	boot		
planetlab3.rutgers.edu	PLC	boot		
ttu2-1.nodes.planet-lab.org	PLC	boot		
planetlab1.tsuniv.edu	PLC	boot		
planetlab2.buaa.edu.cn	PLC	boot		
planetlab2.jhu.edu	PLC	boot		
planetlab2.tsuniv.edu	PLC	boot		
planetlab2.tlm.unavarra.es	PLE	boot		
prata.mimuw.edu.pl	PLE	boot		
planetlab-1.cse.ohio-state.edu	PLC	boot		
pl1.cs.unm.edu	PLC	boot		
planetlab1.cs.pitt.edu	PLC	boot		
pl1.cs.montana.edu	PLC	boot		
planetlab01.alucloud.com	PLC	boot		
planet-plc-5.mpi-sws.org	PLC	boot		
planetlab2.fct.ualg.pt	PLE	boot		
planetlab1.utt.fr	PLE	boot		
planetlab-2.research.netlab.hut.fi	PLE	boot		
pl1.tailab.eu	PLE	boot		
onelab2.pl.sophia.inria.fr	PLE	boot		
pl1snu.koren.kr	PLC	boot		
planet1.jaist.ac.jp	PLC	boot		
planetlab1.iii.u-tokyo.ac.jp	PLC	boot		
planetlab-2.fhi-fokus.de	PLE	boot		
planetlab03.cs.washington.edu	PLC	boot		
planet2.scs.stanford.edu	PLC	boot		
righthand.eecs.harvard.edu	PLC	boot		
ricepl-2.cs.rice.edu	PLC	boot		
planetlab-1.fhi-fokus.de	PLE	boot		
planetlab2.cs.umass.edu	PLC	boot		
orbpl1.rutgers.edu	PLC	boot		
planetlab-01.ece.uprm.edu	PLC	boot		
planetlab1.cnds.jhu.edu	PLC	boot		
plnode02.cs.mu.oz.au	PLC	boot		
lefthand.eecs.harvard.edu	PLC	boot		
planet0.jaist.ac.jp	PLC	boot		
planetlab2.ucsd.edu	PLC	boot		
csplanetlab4.kaist.ac.kr	PLC	boot		
planetlab0.otemachi.wide.ad.jp	PLC	boot		
planetlab6.csail.mit.edu	PLC	boot		
pl2-higashi.ics.es.osaka-u.ac.jp	PLC	boot		
planetlab-2a.ics.uci.edu	PLC	boot		
planetlab2.singaren.net.sg	PLC	boot		
planetlab-2.cs.colostate.edu	PLC	boot		
pli1-pa-3.hpl.hp.com	PLC	boot		
planetlab1.fit.vutbr.cz	PLC	boot		
planetlab4.mini.pw.edu.pl	PLC	boot		
pl1.prakinf.tu-ilmenau.de	PLE	boot		
planet1.cc.gt.atl.ga.us	PLC	boot		
planetlab1.cis.upenn.edu	PLC	boot		
planetlab4.singaren.net.sg	PLC	boot		
planetlab3.cs.uiuc.edu	PLC	boot		
pl2.rcc.uottawa.ca	PLC	boot		
planetlab-1.calpoly-netlab.net	PLC	boot		
pl1.rcc.uottawa.ca	PLC	boot		
kupl2.ittc.ku.edu	PLC	boot		
planetlab1.cs.columbia.edu	PLC	boot		
planetlab-1.ing.unimo.it	PLE	boot		
planetlab1.koganei.itrc.net	PLC	boot		
f20bootcd.cs.princeton.edu	PLC	boot		
planetlab1.cs.uoregon.edu	PLC	boot		
planetlab1.csie.nuk.edu.tw	PLC	boot		
planetlab1.bgu.ac.il	PLC	boot		
planetlab-03.cs.princeton.edu	PLC	boot		
pl2.eng.monash.edu.au	PLC	boot		
planetlab5.millennium.berkeley.edu	PLC	boot		
planetlab1.pop-ce.rnp.br	PLC	boot		
planetlab2.pop-ce.rnp.br	PLC	boot		
planetlab-1.sjtu.edu.cn	PLC	boot		
planet1.scs.stanford.edu	PLC	boot		
planet12.csc.ncsu.edu	PLC	boot		
pl1.sos.info.hiroshima-cu.ac.jp	PLC	boot		
recall.snu.ac.kr	PLC	boot		
planetlab4.bupt.edu.cn	PLC	boot		
planetlab2.cqupt.edu.cn	PLC	boot		
planetlab1.cqupt.edu.cn	PLC	boot		
pl1.csl.utoronto.ca	PLC	boot		
planetlab-1.cmcl.cs.cmu.edu	PLC	boot		
planetlab1.cs.cornell.edu	PLC	boot		
plnode01.cs.mu.oz.au	PLC	boot		
planetlab1.eecs.umich.edu	PLC	boot		
planetlab2.netlab.uky.edu	PLC	boot		
kupl1.ittc.ku.edu	PLC	boot		
planetlab2.cs.uiuc.edu	PLC	boot		
planetlab-2.scie.uestc.edu.cn	PLC	boot		
pl2.cs.montana.edu	PLC	boot		
pl221nassau0.cs.princeton.edu	PLC	boot		
planetlab02.alucloud.com	PLC	boot		
planet-lab-node1.netgroup.uniroma2.it	PLE	boot		
planetlab1.mnlab.cti.depaul.edu	PLC	boot		
planetlab1.cs.uiuc.edu	PLC	boot		
planetlab1.cs.unc.edu	PLC	boot		
planetlab2.een.orst.edu	PLC	boot		
planetlab1.net.in.tum.de	PLE	boot		
pli1-pa-2.hpl.hp.com	PLC	boot		
plab-1.sinp.msu.ru	PLC	boot		
planetlab2.eecs.ucf.edu	PLC	boot		
planetlab1.comp.nus.edu.sg	PLC	boot		
planet-lab1.ufabc.edu.br	PLC	boot		
planetlab1.pop-mg.rnp.br	PLC	boot		
planetlab2.pop-mg.rnp.br	PLC	boot		
server1.planetlab.iit-tech.net	PLC	boot		
planetlab1.poly.edu	PLC	boot		
planetlab2.eee.hku.hk	PLC	boot		
planetlab-2.usask.ca	PLC	boot		
planetlab3.netmedia.gist.ac.kr	PLC	boot		
planetlab2.arizona-gigapop.net	PLC	boot		
planetlab1.buaa.edu.cn	PLC	boot		
planetlab6.flux.utah.edu	PLC	boot		
planetlab7.flux.utah.edu	PLC	boot		
planetlab2.eecs.wsu.edu	PLC	boot		
planetlab-2.cmcl.cs.cmu.edu	PLC	boot		
planetlab1.sfc.wide.ad.jp	PLC	boot		
planetlab2.cesnet.cz	PLC	boot		
kc-sce-plab2.umkc.edu	PLC	boot		
planetlab2.sfc.wide.ad.jp	PLC	boot		
planetlab1.cesnet.cz	PLC	boot		
planetlab04.cs.washington.edu	PLC	boot		
planetlab3.ucsd.edu	PLC	boot		
csplanetlab3.kaist.ac.kr	PLC	boot		
plab1.engr.sjsu.edu	PLC	boot		
plab2.engr.sjsu.edu	PLC	boot		
planet2.cc.gt.atl.ga.us	PLC	boot		
planet3.cc.gt.atl.ga.us	PLC	boot		
planet4.cc.gt.atl.ga.us	PLC	boot		
planetlab1.otemachi.wide.ad.jp	PLC	boot		
planetlab1.dojima.wide.ad.jp	PLC	boot		
planetlab1.singaren.net.sg	PLC	boot		
planetlab1.netmedia.gist.ac.kr	PLC	boot		
planetlab4.csail.mit.edu	PLC	boot		
planetlab-01.kusa.ac.jp	PLC	boot		
planetlab-02.kusa.ac.jp	PLC	boot		
planetlab1.emich.edu	PLC	boot		
planetlab2.emich.edu	PLC	boot		
planetlab-02.vt.nodes.planet-lab.org	PLC	boot		
metis.mcs.suffolk.edu	PLC	boot		
planetlab4.cs.duke.edu	PLC	boot		
planetlab5.cs.cornell.edu	PLC	boot		
planetlab4.ie.cuhk.edu.hk	PLC	boot		
planetlab3.mini.pw.edu.pl	PLC	boot		
planetlab1.netlab.uky.edu	PLC	boot		
planetlab5.ie.cuhk.edu.hk	PLC	boot		
planetlab1.inf.ethz.ch	PLC	boot		
planetlab2.inf.ethz.ch	PLC	boot		
planetlab1.eas.asu.edu	PLC	boot		
planetlab4.flux.utah.edu	PLC	boot		
planetlab5.flux.utah.edu	PLC	boot		
pub1-s.ane.cmc.osaka-u.ac.jp	PLC	boot		
pub2-s.ane.cmc.osaka-u.ac.jp	PLC	boot		
planetlab2.eas.asu.edu	PLC	boot		
ple1.ait.ac.th	PLE	boot		
planetlab2.citadel.edu	PLC	boot		
planetlab3.inf.ethz.ch	PLC	boot		
planetlab1.arizona-gigapop.net	PLC	boot		
planetlab1-santiago.lan.redclara.net	PLC	boot		
planetlab2-santiago.lan.redclara.net	PLC	boot		
planetlab4.inf.ethz.ch	PLC	boot		
planetlab2-saopaulo.lan.redclara.net	PLC	boot		
planetlab1-buenosaires.lan.redclara.net	PLC	boot		
orval.infonet.fundp.ac.be	PLE	boot		
planetlab1.byu.edu	PLC	boot		
planetlab2.utep.edu	PLC	boot		
planetlab2.byu.edu	PLC	boot		
plab-2.sinp.msu.ru	PLC	boot		
planetlab-02.bu.edu	PLC	boot		
pli1-pa-5.hpl.hp.com	PLC	boot		
planetlab1.eecs.ucf.edu	PLC	boot		
planetlab4.warsaw.rd.tp.pl	PLC	boot		
planetlab2.williams.edu	PLC	boot		
planetlab3.williams.edu	PLC	boot		
planetlab02.sys.virginia.edu	PLC	boot		
planetlab2.cs.columbia.edu	PLC	boot		
pl3.planetlab.uvic.ca	PLC	boot		
pl2.cs.unm.edu	PLC	boot		
pl3.cs.unm.edu	PLC	boot		
planetlab2.comp.nus.edu.sg	PLC	boot		
saturn.cs.brown.edu	PLC	boot		
jupiter.cs.brown.edu	PLC	boot		
earth.cs.brown.edu	PLC	boot		
planetlabone.ccs.neu.edu	PLC	boot		
planetlab2.engr.uconn.edu	PLC	boot		
planetlab2.cs.unc.edu	PLC	boot		
newbootcd.cs.princeton.edu	PLC	boot		
mtuplanetlab1.cs.mtu.edu	PLC	boot		
pl1.eecs.utk.edu	PLC	boot		
planetlab1.cs.umass.edu	PLC	boot		
planet-lab2.ufabc.edu.br	PLC	boot		
planetlab3.cs.uchicago.edu	PLC	boot		
planetx.scs.cs.nyu.edu	PLC	boot		
planetlab15.millennium.berkeley.edu	PLC	boot		
plgmu2.ite.gmu.edu	PLC	boot		
planet1.ku.edu.tr	PLC	boot		
planet2.ku.edu.tr	PLC	boot		
planetlab2.cs.cornell.edu	PLC	boot		
pl1.ucs.indiana.edu	PLC	boot		
pl2.ucs.indiana.edu	PLC	boot		
planetlab1.cs.umb.edu	PLC	boot		
planetlab2.cs.umb.edu	PLC	boot		
cs-planetlab4.cs.surrey.sfu.ca	PLC	boot		
planetlab5.csres.utexas.edu	PLC	boot		
planetlab3.eecs.northwestern.edu	PLC	boot		
vn4.cse.wustl.edu	PLC	boot		
planetlab4.williams.edu	PLC	boot		
planetlab5.williams.edu	PLC	boot		
planetslug4.cse.ucsc.edu	PLC	boot		
planetlab3.cse.nd.edu	PLC	boot		
node2.planetlab.mathcs.emory.edu	PLC	boot		
node1.planetlab.mathcs.emory.edu	PLC	boot		
planetlab2.utdallas.edu	PLC	boot		
nodea.howard.edu	PLC	boot		
plab2.cs.ust.hk	PLC	boot		
planetlab3.wail.wisc.edu	PLC	boot		
planetlab1.utdallas.edu	PLC	boot		
planetlab3.postel.org	PLC	boot		
planet-lab2.cs.ucr.edu	PLC	boot		
planetlab3.eecs.umich.edu	PLC	boot		
plab4.eece.ksu.edu	PLC	boot		
server3.planetlab.iit-tech.net	PLC	boot		
planetlab1.csee.usf.edu	PLC	boot		
planet-lab2.itba.edu.ar	PLC	boot		
planetlab2.pop-rs.rnp.br	PLC	boot		
planetlab-2.cse.ohio-state.edu	PLC	boot		
planetlab4.postel.org	PLC	boot		
plab3.eece.ksu.edu	PLC	boot		
planet-lab1.uba.ar	PLC	boot		
planetlab2.cs.purdue.edu	PLC	boot		
plonk.cs.uwaterloo.ca	PLC	boot		
planetlab2.c3sl.ufpr.br	PLC	boot		
planetlab2.cs.otago.ac.nz	PLC	boot		
planetlab2.cs.ucl.ac.uk	PLC	boot		
planetlab1.cs.otago.ac.nz	PLC	boot		
planetlab1.iis.sinica.edu.tw	PLC	boot		
node1.planetlab.albany.edu	PLC	boot		
node2.planetlab.albany.edu	PLC	boot		
planetlab2.acis.ufl.edu	PLC	boot		
planetlab3.singaren.net.sg	PLC	boot		
server2.planetlab.iit-tech.net	PLC	boot		
roam1.cs.ou.edu	PLC	boot		
osiris.planetlab.cs.umd.edu	PLC	boot		
whitefall.planetlab.cs.umd.edu	PLC	boot		
planetlab-2.ece.iastate.edu	PLC	boot		
planet-lab2.uba.ar	PLC	boot		
planetlab2.unl.edu	PLC	boot		
planetlab-01.cs.princeton.edu	PLC	boot		
pl3.planet.cs.kent.edu	PLC	boot		
planetlab0.ucsc.cmb.ac.lk	PLC	boot		
saturn.planetlab.carleton.ca	PLC	boot		
planetlab2.hust.edu.cn	PLC	boot		
planetlab6.cs.cornell.edu	PLC	boot		
planetlab4.n.info.eng.osaka-cu.ac.jp	PLC	boot		
planetlab4.goto.info.waseda.ac.jp	PLC	boot		
planetlab1.ntu.nodes.planet-lab.org	PLC	boot		
planetlab01.cs.washington.edu	PLC	boot		
planetlab-1.cs.auckland.ac.nz	PLC	boot		
planetlab-2.cs.auckland.ac.nz	PLC	boot		
planetlab1.eecs.wsu.edu	PLC	boot		
planetlab-04.cs.princeton.edu	PLC	boot		
planetlab1.ewi.tudelft.nl	PLC	boot		
planetlab-2.cs.uic.edu	PLC	boot		
plnodea.plaust.edu.cn	PLC	boot		
flow.colgate.edu	PLC	boot		
planetlab-2.webedu.ccu.edu.tw	PLC	boot		
planetlab-01.vt.nodes.planet-lab.org	PLC	boot		
planetlab-2.sjtu.edu.cn	PLC	boot		
adrastea.mcs.suffolk.edu	PLC	boot		
planetlab4.cs.uoregon.edu	PLC	boot		
planet-lab-node2.netgroup.uniroma2.it	PLE	boot		
anateus.ipv6.lip6.fr	PLE	boot		
planetlab1.cs.ucla.edu	PLC	boot		
planetlab2.cs.ucla.edu	PLC	boot		
kc-sce-plab1.umkc.edu	PLC	boot		
planetlab9.millennium.berkeley.edu	PLC	boot		
planetlab7.millennium.berkeley.edu	PLC	boot		
planetlab10.millennium.berkeley.edu	PLC	boot		
planetlab11.millennium.berkeley.edu	PLC	boot		
pli1-br-1.hpl.hp.com	PLC	boot		
planetlab6.cs.duke.edu	PLC	boot		
planetlab2.ntu.nodes.planet-lab.org	PLC	boot		
planetlab7.cs.duke.edu	PLC	boot		
planetlab01.sys.virginia.edu	PLC	boot		
pluto.cs.brown.edu	PLC	boot		
planetlab4.cse.nd.edu	PLC	boot		
planetslug5.cse.ucsc.edu	PLC	boot		
plab2.larc.usp.br	PLC	boot		
vn5.cse.wustl.edu	PLC	boot		
planet3.cs.ucsb.edu	PLC	boot		
planetlab5.cs.uiuc.edu	PLC	boot		
planetlab6.cs.uiuc.edu	PLC	boot		
planetlab-04.vt.nodes.planet-lab.org	PLC	boot		
planetlab5.csee.usf.edu	PLC	boot		
planetlab-4.eecs.cwru.edu	PLC	boot		
pl1.planet.cs.kent.edu	PLC	boot		
planetlab-6.ece.iastate.edu	PLC	boot		
planetlab6.csee.usf.edu	PLC	boot		
planetlab1-saopaulo.lan.redclara.net	PLC	boot		
planetlab3.cnds.jhu.edu	PLC	boot		
planetlab4.cnds.jhu.edu	PLC	boot		
server4.planetlab.iit-tech.net	PLC	boot		
planet4.cs.ucsb.edu	PLC	boot		
planetlab-1.pdl.nudt.edu.cn	PLC	boot		
plgmu3.ite.gmu.edu	PLC	boot		
plgmu4.ite.gmu.edu	PLC	boot		
pl2.pku.edu.cn	PLC	boot		
planetlab3.arizona-gigapop.net	PLC	boot		
ricepl-5.cs.rice.edu	PLC	boot		
pnode2.pdcc-ntu.singaren.net.sg	PLC	boot		
plnode-04.gpolab.bbn.com	PLC	boot		
planetlab2.pop-pa.rnp.br	PLC	boot		
planetlab3.canterbury.ac.nz	PLC	boot		
planetlab4.canterbury.ac.nz	PLC	boot		
planetlab2.ecs.vuw.ac.nz	PLC	boot		
planet5.cs.ucsb.edu	PLC	boot		
planet6.cs.ucsb.edu	PLC	boot		
planetlab02.just.edu.jo	PLC	boot		
plnode-03.gpolab.bbn.com	PLC	boot		
planetlab1.ecs.vuw.ac.nz	PLC	boot		
planetlab-1.elisa.cpsc.ucalgary.ca	PLC	boot		
planetlab1.cs.stevens-tech.edu	PLC	boot		
planetlab1.pop-pa.rnp.br	PLC	boot		
planetlab2.cs.uml.edu	PLC	boot		
planetlab-n2.wand.net.nz	PLC	boot		
planetlab2.clemson.edu	PLC	boot		
pl1.6test.edu.cn	PLC	boot		
pl2.6test.edu.cn	PLC	boot		
planetlab-n1.wand.net.nz	PLC	boot		
planetlab1.een.orst.edu	PLC	boot		
planetlab1.cs.uml.edu	PLC	boot		
planetlab1.clemson.edu	PLC	boot		
pl2.sos.info.hiroshima-cu.ac.jp	PLC	boot		
planetlab-1.sysu.edu.cn	PLC	boot		
planetlab-2.sysu.edu.cn	PLC	boot		
mtuplanetlab2.cs.mtu.edu	PLC	boot		
planetlab-1.scie.uestc.edu.cn	PLC	boot		
planet-lab1.itba.edu.ar	PLC	boot		
planetlab3.comp.nus.edu.sg	PLC	boot		
plink.cs.uwaterloo.ca	PLC	boot		
planet11.csc.ncsu.edu	PLC	boot		
pl1.pku.edu.cn	PLC	boot		
planetlab1.plab.ege.edu.tr	PLC	boot		
planetlab-03.vt.nodes.planet-lab.org	PLC	boot		
planetlab1.eee.hku.hk	PLC	boot		
planetlab1.c3sl.ufpr.br	PLC	boot		
planet1.pnl.nitech.ac.jp	PLC	boot		
planet2.pnl.nitech.ac.jp	PLC	boot		
planet1.dsp.ac.cn	PLC	boot		
planet2.dsp.ac.cn	PLC	boot		
planetlab1.aut.ac.nz	PLC	boot		
planetlab2.aut.ac.nz	PLC	boot		
pl2.cs.yale.edu	PLC	boot		
pl1.cs.yale.edu	PLC	boot		
planetlab1.cs.ucl.ac.uk	PLC	boot		
roam2.cs.ou.edu	PLC	boot		
pl1.cis.uab.edu	PLC	boot		
planetlab1.ie.cuhk.edu.hk	PLC	boot		
planetlab4.tamu.edu	PLC	boot		
planetlab-4.ece.iastate.edu	PLC	boot		
planetlab1.cnis.nyit.edu	PLC	boot		
planet2.cs.rochester.edu	PLC	boot		
pl2.cis.uab.edu	PLC	boot		
planetlab2.cnis.nyit.edu	PLC	boot		
pl-dccd-02.cua.uam.mx	PLC	boot		
arari.snu.ac.kr	PLC	boot		
planetlab1.umassd.edu	PLC	boot		
planetlab2.umassd.edu	PLC	boot		
pl2.yonsei.ac.kr	PLC	boot		
planetlab1.hust.edu.cn	PLC	boot		
planetlab2.nakao-lab.org	PLC	boot		
plab1.cs.msu.ru	PLC	boot		
plab3.cs.msu.ru	PLC	boot		
planetlab1.iitkgp.ac.in	PLC	boot		
planetlab2.iitkgp.ac.in	PLC	boot		
nodeb.howard.edu	PLC	boot		
planetlab2.ustc.edu.cn	PLC	boot		
planetlab3.bupt.edu.cn	PLC	boot		
planetlab-js1.cert.org.cn	PLC	boot		
planetlab1.warsaw.rd.tp.pl	PLC	boot		
planetlab-5.ece.iastate.edu	PLC	boot		
pl1-higashi.ics.es.osaka-u.ac.jp	PLC	boot		
planetlab1.cti.espol.edu.ec	PLC	boot		
planetlab2.cti.espol.edu.ec	PLC	boot		
75-130-96-12.static.oxfr.ma.charter.com	PLC	boot		
75-130-96-13.static.oxfr.ma.charter.com	PLC	boot		
planetlabtwo.ccs.neu.edu	PLC	boot		
planetlab-2.ssvl.kth.se	PLC	boot		
planet-plc-2.mpi-sws.org	PLC	boot		
planet-plc-3.mpi-sws.org	PLC	boot		
planet-plc-4.mpi-sws.org	PLC	boot		
planetlab1.cs.okstate.edu	PLC	boot		
planet-plc-6.mpi-sws.org	PLC	boot		
planetlab1.temple.edu	PLC	boot		
planetlab2.temple.edu	PLC	boot		
planetvs2.informatik.uni-stuttgart.de	PLE	boot		
pl-dccd-01.cua.uam.mx	PLC	boot		
planetlab2.cs.du.edu	PLC	boot		
planetlab1.engr.uconn.edu	PLC	boot		
pl1.yonsei.ac.kr	PLC	boot		
planetlab1.mini.pw.edu.pl	PLE	boot		
planetlab-1.ssvl.kth.se	PLC	boot		
planetlab2.mnlab.cti.depaul.edu	PLC	boot		
plab2.nec-labs.com	PLC	boot		
planetlab2.rutgers.edu	PLC	boot		
pli1-pa-4.hpl.hp.com	PLC	boot		
planetlab1.millennium.berkeley.edu	PLC	boot		
planetlab-3.ece.iastate.edu	PLC	boot		
planetlab1.acis.ufl.edu	PLC	boot		
peeramidion.irisa.fr	PLE	boot		
planetlab2.plab.ege.edu.tr	PLC	boot		
planetlab05.cs.washington.edu	PLC	boot		
planetslug7.cse.ucsc.edu	PLC	boot		
planetlab4.cs.uchicago.edu	PLC	boot		
planetlab2.millennium.berkeley.edu	PLC	boot		
planetlab-tea.ait.ie	PLE	boot		
ple6.ipv6.lip6.fr	PLE	boot		
pl2.csl.utoronto.ca	PLC	boot		
planetlab1.pop-rs.rnp.br	PLC	boot		
planetlab3.georgetown.edu	PLC	boot		
planetlab-3.cmcl.cs.cmu.edu	PLC	boot		
planetlab7.csail.mit.edu	PLC	boot		
planetlab01.uncc.edu	PLC	boot		
planetlab-2.calpoly-netlab.net	PLC	boot		
nis-planet1.doshisha.ac.jp	PLC	boot		
planetlab1.csuohio.edu	PLC	boot		
planetlab-1.cs.uic.edu	PLC	boot		
pl-node-0.csl.sri.com	PLC	boot		
pl-node-1.csl.sri.com	PLC	boot		
ttu1-1.nodes.planet-lab.org	PLC	boot		
planetlab1.ustc.edu.cn	PLC	boot		
planetlab1.rutgers.edu	PLC	boot		
planetlab1.cs.uit.no	PLE	boot
